###|Informação não fornecida (###)
zxx|Sem material linguístico (zxx)
mul|Múltiplos idiomas (mul)
sgn|Linguagem de sinais (sgn)
und|Indeterminado (und)
aar|Afar (aar)
abk|Abkhaz (abk)
ace|Achinese (ace)
ach|Acoli (ach)
ada|Adangme (ada)
ady|Adygei (ady)
afa|Afroasiatic (e outros) (afa)
afh|Afrihili (Artificial language) (afh)
afr|Afrikaans (afr)
ain|Ainu (ain)
aka|Akan (aka)
akk|Akkadian (akk)
alb|Albanian (alb)
ale|Aleut (ale)
alg|Algonquian (e outros) (alg)
alt|Altai (alt)
amh|Amharic (amh)
ang|English, Old (ca. 450-1100) (ang)
anp|Angika (anp)
apa|Apache languages (apa)
ara|Arabic (ara)
arc|Aramaic (arc)
arg|Aragonese (arg)
arm|Armenian (arm)
arn|Mapuche (arn)
arp|Arapaho (arp)
art|Artificial (e outros) (art)
arw|Arawak (arw)
asm|Assamese (asm)
ast|Bable (ast)
ath|Athapascan (e outros) (ath)
aus|Australian languages (aus)
ava|Avaric (ava)
ave|Avestan (ave)
awa|Awadhi (awa)
aym|Aymara (aym)
aze|Azerbaijani (aze)
bad|Banda languages (bad)
bai|Bamileke languages (bai)
bak|Bashkir (bak)
bal|Baluchi (bal)
bam|Bambara (bam)
ban|Balinese (ban)
baq|Basco (baq)
bas|Basa (bas)
bat|Baltic (e outros) (bat)
bej|Beja (bej)
bel|Belarusian (bel)
bem|Bemba (bem)
ben|Bengali (ben)
ber|Berber (e outros) (ber)
bho|Bhojpuri (bho)
bih|Bihari (bih)
bik|Bikol (bik)
bin|Edo (bin)
bis|Bislama (bis)
bla|Siksika (bla)
bnt|Bantu (e outros) (bnt)
bos|Bosnian (bos)
bra|Braj (bra)
bre|Breton (bre)
btk|Batak (btk)
bua|Buriat (bua)
bug|Bugis (bug)
bul|Bulgarian (bul)
bur|Burmese (bur)
byn|Bilin (byn)
cad|Caddo (cad)
cai|Central American Indian (e outros) (cai)
car|Carib (car)
cat|CCatalão (cat)
cau|Caucasian (e outros) (cau)
ceb|Cebuano (ceb)
cel|Celtic (e outros) (cel)
cha|Chamorro (cha)
chb|Chibcha (chb)
che|Chechen (che)
chg|Chagatai (chg)
chi|Chinês (chi)
chk|Chuukese (chk)
chm|Mari (chm)
chn|Chinook jargon (chn)
cho|Choctaw (cho)
chp|Chipewyan (chp)
chr|Cherokee (chr)
chu|Church Slavic (chu)
chv|Chuvash (chv)
chy|Cheyenne (chy)
cmc|Chamic languages (cmc)
cop|Coptic (cop)
cor|Cornish (cor)
cos|Corsican (cos)
cpe|Crioules e Pidgins, baseada em Inglês (e outros) (cpe)
cpf|Crioules e Pidgins, baseada em Francês (e outros) (cpf)
cpp|Crioules e Pidgins, baseada em Português (e outros) (cpp)
cre|Cree (cre)
crh|Crimean Tatar (crh)
crp|Crioules e Pidgins (e outros) (crp)
csb|Kashubian (csb)
cus|Cushitic (e outros) (cus)
cze|Czech (cze)
dak|Dakota (dak)
dan|Danish (dan)
dar|Dargwa (dar)
day|Dayak (day)
del|Delaware (del)
den|Slave (den)
dgr|Dogrib (dgr)
din|Dinka (din)
div|Divehi (div)
doi|Dogri (doi)
dra|Dravidian (e outros) (dra)
dsb|Lower Sorbian (dsb)
dua|Duala (dua)
dum|Dutch, Middle (ca. 1050-1350) (dum)
dut|Holandês (dut)
dyu|Dyula (dyu)
dzo|Dzongkha (dzo)
efi|Efik (efi)
egy|Egyptian (egy)
eka|Ekajuk (eka)
elx|Elamite (elx)
eng|Inglês (eng)
enm|Inglês, Middle (1100-1500) (enm)
epo|Esperanto (epo)
est|Estonian (est)
ewe|Ewe (ewe)
ewo|Ewondo (ewo)
fan|Fang (fan)
fao|Faroese (fao)
fat|Fanti (fat)
fij|Fijian (fij)
fil|Filipino (fil)
fin|Finnish (fin)
fiu|Finno-Ugrian (e outros) (fiu)
fon|Fon (fon)
fre|Francês (fre)
frm|French, Middle (ca. 1300-1600) (frm)
fro|French, Old (ca. 842-1300) (fro)
frr|North Frisian (frr)
frs|East Frisian (frs)
fry|Frisian (fry)
ful|Fula (ful)
fur|Friulian (fur)
gaa|Gã (gaa)
gay|Gayo (gay)
gba|Gbaya (gba)
gem|Germanic (e outros) (gem)
geo|Georgian (geo)
ger|Alemão (ger)
gez|Ethiopic (gez)
gil|Gilbertese (gil)
gla|Scottish Gaelic (gla)
gle|Irish (gle)
glg|Galician (glg)
glv|Manx (glv)
gmh|German, Middle High (ca. 1050-1500) (gmh)
goh|German, Old High (ca. 750-1050) (goh)
gon|Gondi (gon)
gor|Gorontalo (gor)
got|Gothic (got)
grb|Grebo (grb)
grc|Grego, Ancient (to 1453) (grc)
gre|Grego, Moderno (1453-) (gre)
grn|Guarani (grn)
gsw|Swiss German (gsw)
guj|Gujarati (guj)
gwi|Gwich'in (gwi)
hai|Haida (hai)
hat|Haitian French Creole (hat)
hau|Hausa (hau)
haw|Hawaiian (haw)
heb|Hebraico (heb)
her|Herero (her)
hil|Hiligaynon (hil)
him|Western Pahari languages (him)
hin|Hindi (hin)
hit|Hittite (hit)
hmn|Hmong (hmn)
hmo|Hiri Motu (hmo)
hrv|Croatian (hrv)
hsb|Upper Sorbian (hsb)
hun|Hungarian (hun)
hup|Hupa (hup)
iba|Iban (iba)
ibo|Igbo (ibo)
ice|Icelandic (ice)
ido|Ido (ido)
iii|Sichuan Yi (iii)
ijo|Ijo (ijo)
iku|Inuktitut (iku)
ile|Interlingue (ile)
ilo|Iloko (ilo)
ina|Interlingua (International Auxiliary Language Association) (ina)
inc|Indic (e outros) (inc)
ind|Indonesian (ind)
ine|Indo-European (e outros) (ine)
inh|Ingush (inh)
ipk|Inupiaq (ipk)
ira|Iranian (e outros) (ira)
iro|Iroquoian (e outros) (iro)
ita|Italiano (ita)
jav|Javanese (jav)
jbo|Lojban (Artificial language) (jbo)
jpn|Japonês (jpn)
jpr|Judeo-Persian (jpr)
jrb|Judeo-Arabic (jrb)
kaa|Kara-Kalpak (kaa)
kab|Kabyle (kab)
kac|Kachin (kac)
kal|Kalâtdlisut (kal)
kam|Kamba (kam)
kan|Kannada (kan)
kar|Karen languages (kar)
kas|Kashmiri (kas)
kau|Kanuri (kau)
kaw|Kawi (kaw)
kaz|Kazakh (kaz)
kbd|Kabardian (kbd)
kha|Khasi (kha)
khi|Khoisan (e outros) (khi)
khm|Khmer (khm)
kho|Khotanese (kho)
kik|Kikuyu (kik)
kin|Kinyarwanda (kin)
kir|Kyrgyz (kir)
kmb|Kimbundu (kmb)
kok|Konkani (kok)
kom|Komi (kom)
kon|Kongo (kon)
kor|Korean (kor)
kos|Kusaie (kos)
kpe|Kpelle (kpe)
krc|Karachay-Balkar (krc)
krl|Karelian (krl)
kro|Kru (e outros) (kro)
kru|Kurukh (kru)
kua|Kuanyama (kua)
kum|Kumyk (kum)
kur|Kurdish (kur)
kut|Kootenai (kut)
lad|Ladino (lad)
lah|Lahnd? (lah)
lam|Lamba (Zambia and Congo) (lam)
lao|Lao (lao)
lat|Latim (lat)
lav|Latvian (lav)
lez|Lezgian (lez)
lim|Limburgish (lim)
lin|Lingala (lin)
lit|Lithuanian (lit)
lol|Mongo-Nkundu (lol)
loz|Lozi (loz)
ltz|Luxembourgish (ltz)
lua|Luba-Lulua (lua)
lub|Luba-Katanga (lub)
lug|Ganda (lug)
lui|Luiseño (lui)
lun|Lunda (lun)
luo|Luo (Kenya and Tanzania) (luo)
lus|Lushai (lus)
mac|Macedonian (mac)
mad|Madurese (mad)
mag|Magahi (mag)
mah|Marshallese (mah)
mai|Maithili (mai)
mak|Makasar (mak)
mal|Malayalam (mal)
man|Mandingo (man)
mao|Maori (mao)
map|Austronesian (e outros) (map)
mar|Marathi (mar)
mas|Masai (mas)
may|Malay (may)
mdf|Moksha (mdf)
mdr|Mandar (mdr)
men|Mende (men)
mga|Irish, Middle (ca. 1100-1550) (mga)
mic|Micmac (mic)
min|Minangkabau (min)
mis|Miscellaneous languages (mis)
mkh|Mon-Khmer (e outros) (mkh)
mlg|Malagasy (mlg)
mlt|Maltese (mlt)
mnc|Manchu (mnc)
mni|Manipuri (mni)
mno|Manobo languages (mno)
moh|Mohawk (moh)
mon|Mongolian (mon)
mos|Mooré (mos)
mul|Múltiplas línguas (mul)
mun|Munda (e outros) (mun)
mus|Creek (mus)
mwl|Mirandese (mwl)
mwr|Marwari (mwr)
myn|Mayan languages (myn)
myv|Erzya (myv)
nah|Nahuatl (nah)
nai|North American Indian (e outros) (nai)
nap|Neapolitan Italian (nap)
nau|Nauru (nau)
nav|Navajo (nav)
nbl|Ndebele (South Africa) (nbl)
nde|Ndebele (Zimbabwe) (nde)
ndo|Ndonga (ndo)
nds|Low German (nds)
nep|Nepali (nep)
new|Newari (new)
nia|Nias (nia)
nic|Niger-Kordofanian (e outros) (nic)
niu|Niuean (niu)
nno|Norwegian (Nynorsk) (nno)
nob|Norwegian (Bokmål) (nob)
nog|Nogai (nog)
non|Old Norse (non)
nor|Norwegian (nor)
nqo|N'Ko (nqo)
nso|Northern Sotho (nso)
nub|Nubian languages (nub)
nwc|Newari, Old (nwc)
nya|Nyanja (nya)
nym|Nyamwezi (nym)
nyn|Nyankole (nyn)
nyo|Nyoro (nyo)
nzi|Nzima (nzi)
oci|Occitan (post 1500) (oci)
oji|Ojibwa (oji)
ori|Oriya (ori)
orm|Oromo (orm)
osa|Osage (osa)
oss|Ossetic (oss)
ota|Turkish, Ottoman (ota)
oto|Otomian languages (oto)
paa|Papuan (e outros) (paa)
pag|Pangasinan (pag)
pal|Pahlavi (pal)
pam|Pampanga (pam)
pan|Panjabi (pan)
pap|Papiamento (pap)
pau|Palauan (pau)
peo|Old Persian (ca. 600-400 B.C.) (peo)
per|Persian (per)
phi|Philippine (e outros) (phi)
phn|Phoenician (phn)
pli|Pali (pli)
pol|Polish (pol)
pon|Ponape (pon)
por|Português (por)
pra|Prakrit languages (pra)
pro|Provençal (to 1500) (pro)
pus|Pushto (pus)
que|Quechua (que)
raj|Rajasthani (raj)
rap|Rapanui (rap)
rar|Rarotongan (rar)
roa|Romance (e outros) (roa)
roh|Raeto-Romance (roh)
rom|Romani (rom)
rum|Romanian (rum)
run|Rundi (run)
rup|Aromanian (rup)
rus|Russo (rus)
sad|Sandawe (sad)
sag|Sango (Ubangi Creole) (sag)
sah|Yakut (sah)
sai|South American Indian (e outros) (sai)
sal|Salishan languages (sal)
sam|Samaritan Aramaic (sam)
san|Sanskrit (san)
sas|Sasak (sas)
sat|Santali (sat)
scn|Sicilian Italian (scn)
sco|Scots (sco)
sel|Selkup (sel)
sem|Semitic (e outros) (sem)
sga|Irish, Old (to 1100) (sga)
sgn|Sign languages (sgn)
shn|Shan (shn)
sid|Sidamo (sid)
sin|Sinhalese (sin)
sio|Siouan (e outros) (sio)
sit|Sino-Tibetan (e outros) (sit)
sla|Slavic (e outros) (sla)
slo|Slovak (slo)
slv|Slovenian (slv)
sma|Southern Sami (sma)
sme|Northern Sami (sme)
smi|Sami (smi)
smj|Lule Sami (smj)
smn|Inari Sami (smn)
smo|Samoan (smo)
sms|Skolt Sami (sms)
sna|Shona (sna)
snd|Sindhi (snd)
snk|Soninke (snk)
sog|Sogdian (sog)
som|Somali (som)
son|Songhai (son)
sot|Sotho (sot)
spa|Espanhol (spa)
srd|Sardinian (srd)
srn|Sranan (srn)
srp|Serbian (srp)
srr|Serer (srr)
ssa|Nilo-Saharan (e outros) (ssa)
ssw|Swazi (ssw)
suk|Sukuma (suk)
sun|Sundanese (sun)
sus|Susu (sus)
sux|Sumerian (sux)
swa|Swahili (swa)
swe|Swedish (swe)
syc|Syriac (syc)
syr|Syriac, Modern (syr)
tah|Tahitian (tah)
tai|Tai (e outros) (tai)
tam|Tamil (tam)
tat|Tatar (tat)
tel|Telugu (tel)
tem|Temne (tem)
ter|Terena (ter)
tet|Tetum (tet)
tgk|Tajik (tgk)
tgl|Tagalog (tgl)
tha|Thai (tha)
tib|Tibetan (tib)
tig|Tigré (tig)
tir|Tigrinya (tir)
tiv|Tiv (tiv)
tkl|Tokelauan (tkl)
tlh|Klingon (Artificial language) (tlh)
tli|Tlingit (tli)
tmh|Tamashek (tmh)
tog|Tonga (Nyasa) (tog)
ton|Tongan (ton)
tpi|Tok Pisin (tpi)
tsi|Tsimshian (tsi)
tsn|Tswana (tsn)
tso|Tsonga (tso)
tuk|Turkmen (tuk)
tum|Tumbuka (tum)
tup|Tupi languages (tup)
tur|Turkish (tur)
tut|Altaic (e outros) (tut)
tvl|Tuvaluan (tvl)
twi|Twi (twi)
tyv|Tuvinian (tyv)
udm|Udmurt (udm)
uga|Ugaritic (uga)
uig|Uighur (uig)
ukr|Ukrainian (ukr)
umb|Umbundu (umb)
und|Undetermined (und)
urd|Urdu (urd)
uzb|Uzbek (uzb)
vai|Vai (vai)
ven|Venda (ven)
vie|Vietnamese (vie)
vol|Volapük (vol)
vot|Votic (vot)
wak|Wakashan languages (wak)
wal|Wolayta (wal)
war|Waray (war)
was|Washo (was)
wel|Welsh (wel)
wen|Sorbian (e outros) (wen)
wln|Walloon (wln)
wol|Wolof (wol)
xal|Oirat (xal)
xho|Xhosa (xho)
yao|Yao (Africa) (yao)
yap|Yapese (yap)
yid|Yiddish (yid)
yor|Iorubá (yor)
ypk|Yupik languages (ypk)
zap|Zapotec (zap)
zbl|Blissymbolics (zbl)
zen|Zenaga (zen)
zha|Zhuang (zha)
znd|Zande languages (znd)
zul|Zulu (zul)
zun|Zuni (zun)
zxx|Nenhum conteúdo linguístico (zxx)
zza|Zaza (zza)